#################################################
#                                               #
#                                               #
#                                               #
#                   #                           #
#             #     #     #                     #
#             ##    #    ##                     #
#             # #   #   # #                     #
#             # #   #   # #                     #
#             ##    #    ##   CLAVA             #
#             # # # # # # #                     #
#             ##### # #####   UKRAINI!          #
#                 #   #                         #
#                   #                           #
#                   #                           #
#                                               #
#                                               #
#                                               #
#                                               #
#################################################
