#################################################
#                                               #
#                                               #
#   ?                                           #
#                                               #
#                                               #
#                                               #
#               ################                #
#               #              #                #
#               #              #                #
#                                               #
#               #              #                #
#               #              #                #
#               ################                #
#                                               #
#                                               #
#                                               #
#                                               #
#                                               #
#################################################
