#################################################
#                      #                        #
#                      #                        #
#                      #                        #
###########            #            #############
#                      #                        #
#                                               #
#               ####### ########                #
#               #?            ?#                #
#               #              #                #
#                      ?                        #
#########       #              #       ##########
#               #?            ?#                #
#               ####### ########                #
#                                               #
#                      #                        #
############           #            #############
#                      #                        #
#                      #                        #
#################################################
